
F 255,0 , 0
C 255 255 255

SO out
WE out
NO out
EA out

1111111111