
F 255,0 , 0
C 255 255 255

SO out
WE out
NO out
EA out

11111111
100N0011
11111111
