F 255,0 , 0
C 255 255 255

SO hello
WE hello
NO hello
EA out

111111111