
F 255,0 , 0
C 255 255 255

SO out
WE out
NO out
EA out




111111111110000000000000000
100000000000011100000000000000
100100010011111000000000000000
1001010N1111111111111111111111
111111010000000000000000000000000000
