
F 255,0 , 0
C 255 255 255

SO out
WE out
NO out
EA out

111111111
E

