
F 0,0 , 0
C 255 255 255

SO out
WE out
NO out
EA out

11111111
10000001
100N0011
10000001
11111111
