
F 67, 29, 22
C 0 0 0

SO ./textures/so_tex.xpm
WE ./textures/we_tex.xpm
NO ./textures/no_tex.xpm
EA ./textures/ea_tex.xpm



1111111111111111111111111111111111111111111111111111111111111111111111111111111111111111111111111111
1000000000000000000000000000000000000000000000000110000000000000000000000000000000000000000000000001
1000000000000000000000000000000000000000000000000110000000000000000000000000000000000000000000000001
1000000000000000000000000000000000000000000000000110000000000000000000000000000000000000000000000001
1000000011110000000000000000000000000000000000000110000000111100000000000000000000000000000000000001
1000000011110000000000000000000000000000000000000110000000111100000000000000000000000000000000000001
1000000000000000000000000000000000000000000000000110000000000000000000000000000000000000000000000001
1000000000000000000000000000000000000000000000000110000000000000000000000000000000000000000000000001
1000000000000000000000000000000000000000000000000110000000000000000000000000000000000000000000000001
1000000000000000000000000000000000000000000000000000000000000000000000000000000000000000000000000001
1000000000000000000000000000000000000000000000000000000000000000000000000000000000000000000000000001
1000000000000000100000000000000000000000000000000110000000000000001000000000000000000000000000000001
1000000000000000100000000000000000000000000000000110000000000000001000000000000000000000000000000001
1000000000000111100000000000000000000000000000000110000000000001111000000000000000000000000000000001
1000000000000000000000000000000000000000000000000110000000000000000000000000000000000000000000000001
1000000000000000000000000000000000000000000000000110000000000000000000000000000000000000000000000001
1000000000000000000000000000000000000000000000000110000000000000000000000000000000000000000000000001
1000000000000000000000000000000000101111110000000110000000000000000000000000000000000000000000000001
1000000000000000000000000000000000100000010000000110000000000000000000000000000000000000000000000001
10000000000000000000000000000000001000S0010000000110000000000000000000000000000000000000000000000001
1000000000000000000000000000000011100000011110000110000000000000000000000000000000000000000000000001
1000000000000000000000000000000000000000010000000110000000000000000000000000000000000000000000000001
1000000000000000000000000000000001111111110000000110000000000000000000000000000000000000000000000001
1000000000000000000000000000000000000000000000000110000000000000000000000000000000000000000000000001
1000000000000000000000000000000000000000000000000110000000000000000000000000000000000000000000000001
1000000000000000000000000000000000000000000000000110000000000000000000000000000000000000000000000001
1000000000000000000000000000000000000000000000000110000000000000000000000000000000000000000000000001
1000000000000000000000000000000000000000000000000110000000000000000000000000000000000000000000000001
1000000000000000000000000000000000000000000000000110000000000000000000000000000000000000000000000001
1000000000000000000000000000000000000000000000000110000000000000000000000000000000000000000000000001
1000000000000000000000000000000000000000000000000110000000000000000000000000000000000000000000000001
1000000000000000000000000000000000000000000000000110000000000000000000000000000000000000000000000001
1000000000000000000000000000000000000000000000000110000000000000000000000000000000000000000000000001
1000000000000000000000000000000000000000000000000110000000000000000000000000000000000000000000000001
1000000000000000000000000000000000000000000000000110000000000000000000000000000000000000000000000001
1000000000000000000000000000000000000000000000000110000000000000000000000000000000000000000000000001
1000000000000000000000000000000000000000000000000110000000000000000000000000000000000000000000000001
1000000000000000000000000000000000000000000000000110000000000000000000000000000000000000000000000001
1000000000000000000000000000000000000000000000000110000000000000000000000000000000000000000000000001
1000000000000000000000000000000000000000000000000110000000000000000000000000000000000000000000000001
1000000000000000000000000000000000000000000000000110000000000000000000000000000000000000000000000001
1000000000000000000000000000000000000000000000000110000000000000000000000000000000000000000000000001
1000000000000000000000000000000000000000000000000110000000000000000000000000000000000000000000000001
1000000000000000000000000000000000000000000000000110000000000000000000000000000000000000000000000001
1000000000000000000000000000000000000000000000000110000000000000000000000000000000000000000000000001
1000000000000000000000000000000000000000000000000110000000000000000000000000000000000000000000000001
1000000000000000000000000000000000000000000000000110000000000000000000000000000000000000000000000001
1000000000000000000000000000000000000000000000000110000000000000000000000000000000000000000000000001
1000000000000000000000000000000000000000000000000110000000000000000000000000000000000000000000000001
1111111111111111111111100111111111111111111111111111111111111111111111111111111111111111111111111111
1111111111111111111111100111111111111111111111111111111111111111111111111111111111111111111111111111
1000000000000000000000000000000000000000000000000110000000000000000000000000000000000000000000000001
1000000000000000000000000000000000000000000000000110000000000000000000000000000000000000000000000001
1000000000000000000000000000000000000000000000000110000000000000000000000000000000000000000000000001
1000000011110000000000000000000000000000000000000110000000111100000000000000000000000000000000000001
1000000011110000000000000000000000000000000000000110000000111100000000000000000000000000000000000001
1000000000000000000000000000000000000000000000000110000000000000000000000000000000000000000000000001
1000000000000000000000000000000000000000000000000110000000000000000000000000000000000000000000000001
1000000000000000000000000000000000000000000000000110000000000000000000000000000000000000000000000001
1000000000000000000000000000000000000000000000000000000000000000000000000000000000000000000000000001
1000000000000000000000000000000000000000000000000000000000000000000000000000000000000000000000000001
1000000000000000100000000000000000000000000000000110000000000000001000000000000000000000000000000001
1000000000000000100000000000000000000000000000000110000000000000001000000000000000000000000000000001
1000000000000111100000000000000000000000000000000110000000000001111000000000000000000000000000000001
1000000000000000000000000000000000000000000000000110000000000000000000000000000000000000000000000001
1000000000000000000000000000000000000000000000000110000000000000000000000000000000000000000000000001
1000000000000000000000000000000000000000000000000110000000000000000000000000000000000000000000000001
1000000000000000000000000000000000000000000000000110000000000000000000000000000000000000000000000001
1000000000000000000000000000000000000000000000000110000000000000000000000000000000000000000000000001
1000000000000000000000000000000000000000000000000110000000000000000000000000000000000000000000000001
1000000000000000000000000000000000000000000000000110000000000000000000000000000000000000000000000001
1000000000000000000000000000000000000000000000000110000000000000000000000000000000000000000000000001
1000000000000000000000000000000000000000000000000110000000000000000000000000000000000000000000000001
1000000000000000000000000000000000000000000000000110000000000000000000000000000000000000000000000001
1000000000000000000000000000000000000000000000000110000000000000000000000000000000000000000000000001
1000000000000000000000000000000000000000000000000110000000000000000000000000000000000000000000000001
1000000000000000000000000000000000000000000000000110000000000000000000000000000000000000000000000001
1000000000000000000000000000000000000000000000000110000000000000000000000000000000000000000000000001
1000000000000000000000000000000000000000000000000110000000000000000000000000000000000000000000000001
1000000000000000000000000000000000000000000000000110000000000000000000000000000000000000000000000001
1000000000000000000000000000000000000000000000000110000000000000000000000000000000000000000000000001
1000000000000000000000000000000000000000000000000110000000000000000000000000000000000000000000000001
1000000000000000000000000000000000000000000000000110000000000000000000000000000000000000000000000001
1000000000000000000000000000000000000000000000000110000000000000000000000000000000000000000000000001
1000000000000000000000000000000000000000000000000110000000000000000000000000000000000000000000000001
1000000000000000000000000000000000000000000000000110000000000000000000000000000000000000000000000001
1000000000000000000000000000000000000000000000000110000000000000000000000000000000000000000000000001
1000000000000000000000000000000000000000000000000110000000000000000000000000000000000000000000000001
1000000000000000000000000000000000000000000000000110000000000000000000000000000000000000000000000001
1000000000000000000000000000000000000000000000000110000000000000000000000000000000000000000000000001
1000000000000000000000000000000000000000000000000110000000000000000000000000000000000000000000000001
1000000000000000000000000000000000000000000000000110000000000000000000000000000000000000000000000001
1000000000000000000000000000000000000000000000000110000000000000000000000000000000000000000000000001
1000000000000000000000000000000000000000000000000110000000000000000000000000000000000000000000000001
1000000000000000000000000000000000000000000000000110000000000000000000000000000000000000000000000001
1000000000000000000000000000000000000000000000000110000000000000000000000000000000000000000000000001
1000000000000000000000000000000000000000000000000110000000000000000000000000000000000000000000000001
1000000000000000000000000000000000000000000000000110000000000000000000000000000000000000000000000001
1000000000000000000000000000000000000000000000000110000000000000000000000000000000000000000000000001
1111111111111111111111111111111111111111111111111111111111111111111111111111111111111111111111111111