
F 67, 29, 22
C 0 0 0

SO ./textures/so_tex.xpm
WE ./textures/we_tex.xpm
NO ./textures/no_tex.xpm
EA ./textures/ea_tex.xpm



111111111111111111111111111111
100011100011100011100011100011
101000100000000000100000100101
100000100111111111100100100001
100000100100000000100100100001
100000100100000000100100100001
100000100100000000100100100001
100000100111111111100100100001
100000100000000000000100100001
100000100011100011100011100001
100000100011100011100011100001
100000100100100100100100100001
100000100100100100100100100001
100000100100100100100100100001
100000100000000000000100100001
100000100111111111100100100001
100000100100000000100100100001
100000100100000000100100100001
100000100100000000100100100001
100000100100000000100100100001
100000100111111111100100100001
100000100000000000000100100001
100000100011100011100011100001
100000100011100011100011100001
100000100100100100100100100001
100000100100100100100100100001
10000010010010010010010N100001
100000100000000000000100100001
100000111111111111111100100001
100000000000000000000000000001
111111111111111111111111111111