
F 128, 128, 128
C 0 0 0

SO ./textures/so_tex.xpm
WE ./textures/we_tex.xpm
NO ./textures/no_tex.xpm
EA ./textures/ea_tex.xpm



1111111111111111111111111111111111111111111111111111111111111111111111111111111111111111111111111111
1000000000000000000000000000000000000000000000000110000000000000000000000000000000000000000000000001
1000000000000000000000000000000000000000000000000110000000000000000000000000000000000000000000000001
1000000000000000000000000000000000000000000000000110000000000000000000000000000000000000000000000001
1000000011110000000000000000000000000000000000000110000000111100000000000000000000000000000000000001
1000000011110000000000000000000000000000000000000110000000111100000000000000000000000000000000000001
1000000000000000000000000000000000000000000000000110000000000000000000000000000000000000000000000001
1000000000000000000000000000000000000000000000000110000000000000000000000000000000000000000000000001
1000000000000000000000000000000000000000000000000110000000000000000000000000000000000000000000000001
1000000000000000000000000000000000000000000000000000000000000000000000000000000000000000000000000001
1000000000000000000000000000000000000000000000000000000000000000000000000000000000000000000000000001
1000000000000000100000000000000000000000000000000110000000000000001000000000000000000000000000000001
1000000000000000100000000000000000000000000000000110000000000000001000000000000000000000000000000001
1000000000000111100000000000000000000000000000000110000000000001111000000000000000000000000000000001
1000000000000000000000000000000000000000000000000110000000000000000000000000000000000000000000000001
1000000000000000000000000000000000000000000000000110000000000000000000000000000000000000000000000001
1000000000000000000000000000000000000000000000000110000000000000000000000000000000000000000000000001
1000000000000000000000000000000000000000000000000110000000000000000000000000000000000000000000000001
1000000000000000000000000000000000000000000000000110000000000000000000000000000000000000000000000001
10000000000000000000000000000000000000S0000000000110000000000000000000000000000000000000000000000001
1000000000000000000000000000000000000000000000000110000000000000000000000000000000000000000000000001
1000000000000000000000000000000000000000000000000110000000000000000000000000000000000000000000000001
1000000000000000000000000000000000000000000000000110000000000000000000000000000000000000000000000001
1000000000000000000000000000000000000000000000000110000000000000000000000000000000000000000000000001
1000000000000000000000000000000000000000000000000110000000000000000000000000000000000000000000000001
1000000000000000000000000000000000000000000000000110000000000000000000000000000000000000000000000001
1000000000000000000000000000000000000000000000000110000000000000000000000000000000000000000000000001
1000000000000000000000000000000000000000000000000110000000000000000000000000000000000000000000000001
1000000000000000000000000000000000000000000000000110000000000000000000000000000000000000000000000001
1000000000000000000000000000000000000000000000000110000000000000000000000000000000000000000000000001
1000000000000000000000000000000000000000000000000110000000000000000000000000000000000000000000000001
1000000000000000000000000000000000000000000000000110000000000000000000000000000000000000000000000001
1000000000000000000000000000000000000000000000000110000000000000000000000000000000000000000000000001
1000000000000000000000000000000000000000000000000110000000000000000000000000000000000000000000000001
1000000000000000000000000000000000000000000000000110000000000000000000000000000000000000000000000001
1000000000000000000000000000000000000000000000000110000000000000000000000000000000000000000000000001
1000000000000000000000000000000000000000000000000110000000000000000000000000000000000000000000000001
1000000000000000000000000000000000000000000000000110000000000000000000000000000000000000000000000001
1000000000000000000000000000000000000000000000000110000000000000000000000000000000000000000000000001
1000000000000000000000000000000000000000000000000110000000000000000000000000000000000000000000000001
1000000000000000000000000000000000000000000000000110000000000000000000000000000000000000000000000001
1000000000000000000000000000000000000000000000000110000000000000000000000000000000000000000000000001
1000000000000000000000000000000000000000000000000110000000000000000000000000000000000000000000000001
1000000000000000000000000000000000000000000000000110000000000000000000000000000000000000000000000001
1000000000000000000000000000000000000000000000000110000000000000000000000000000000000000000000000001
1000000000000000000000000000000000000000000000000110000000000000000000000000000000000000000000000001
1000000000000000000000000000000000000000000000000110000000000000000000000000000000000000000000000001
1000000000000000000000000000000000000000000000000110000000000000000000000000000000000000000000000001
1000000000000000000000000000000000000000000000000110000000000000000000000000000000000000000000000001
1111111111111111111111100111111111111111111111111111111111111111111111111111111111111111111111111111
1111111111111111111111100111111111111111111111111111111111111111111111111111111111111111111111111111
1000000000000000000000000000000000000000000000000110000000000000000000000000000000000000000000000001
1000000000000000000000000000000000000000000000000110000000000000000000000000000000000000000000000001
1000000000000000000000000000000000000000000000000110000000000000000000000000000000000000000000000001
1000000011110000000000000000000000000000000000000110000000111100000000000000000000000000000000000001
1000000011110000000000000000000000000000000000000110000000111100000000000000000000000000000000000001
1000000000000000000000000000000000000000000000000110000000000000000000000000000000000000000000000001
1000000000000000000000000000000000000000000000000110000000000000000000000000000000000000000000000001
1000000000000000000000000000000000000000000000000110000000000000000000000000000000000000000000000001
1000000000000000000000000000000000000000000000000000000000000000000000000000000000000000000000000001
1000000000000000000000000000000000000000000000000000000000000000000000000000000000000000000000000001
1000000000000000100000000000000000000000000000000110000000000000001000000000000000000000000000000001
1000000000000000100000000000000000000000000000000110000000000000001000000000000000000000000000000001
1000000000000111100000000000000000000000000000000110000000000001111000000000000000000000000000000001
1000000000000000000000000000000000000000000000000110000000000000000000000000000000000000000000000001
1000000000000000000000000000000000000000000000000110000000000000000000000000000000000000000000000001
1000000000000000000000000000000000000000000000000110000000000000000000000000000000000000000000000001
1000000000000000000000000000000000000000000000000110000000000000000000000000000000000000000000000001
1000000000000000000000000000000000000000000000000110000000000000000000000000000000000000000000000001
1000000000000000000000000000000000000000000000000110000000000000000000000000000000000000000000000001
1000000000000000000000000000000000000000000000000110000000000000000000000000000000000000000000000001
1000000000000000000000000000000000000000000000000110000000000000000000000000000000000000000000000001
1000000000000000000000000000000000000000000000000110000000000000000000000000000000000000000000000001
1000000000000000000000000000000000000000000000000110000000000000000000000000000000000000000000000001
1000000000000000000000000000000000000000000000000110000000000000000000000000000000000000000000000001
1000000000000000000000000000000000000000000000000110000000000000000000000000000000000000000000000001
1000000000000000000000000000000000000000000000000110000000000000000000000000000000000000000000000001
1000000000000000000000000000000000000000000000000110000000000000000000000000000000000000000000000001
1000000000000000000000000000000000000000000000000110000000000000000000000000000000000000000000000001
1000000000000000000000000000000000000000000000000110000000000000000000000000000000000000000000000001
1000000000000000000000000000000000000000000000000110000000000000000000000000000000000000000000000001
1000000000000000000000000000000000000000000000000110000000000000000000000000000000000000000000000001
1000000000000000000000000000000000000000000000000110000000000000000000000000000000000000000000000001
1000000000000000000000000000000000000000000000000110000000000000000000000000000000000000000000000001
1000000000000000000000000000000000000000000000000110000000000000000000000000000000000000000000000001
1000000000000000000000000000000000000000000000000110000000000000000000000000000000000000000000000001
1000000000000000000000000000000000000000000000000110000000000000000000000000000000000000000000000001
1000000000000000000000000000000000000000000000000110000000000000000000000000000000000000000000000001
1000000000000000000000000000000000000000000000000110000000000000000000000000000000000000000000000001
1000000000000000000000000000000000000000000000000110000000000000000000000000000000000000000000000001
1000000000000000000000000000000000000000000000000110000000000000000000000000000000000000000000000001
1000000000000000000000000000000000000000000000000110000000000000000000000000000000000000000000000001
1000000000000000000000000000000000000000000000000110000000000000000000000000000000000000000000000001
1000000000000000000000000000000000000000000000000110000000000000000000000000000000000000000000000001
1000000000000000000000000000000000000000000000000110000000000000000000000000000000000000000000000001
1000000000000000000000000000000000000000000000000110000000000000000000000000000000000000000000000001
1000000000000000000000000000000000000000000000000110000000000000000000000000000000000000000000000001
1000000000000000000000000000000000000000000000000110000000000000000000000000000000000000000000000001
1000000000000000000000000000000000000000000000000110000000000000000000000000000000000000000000000001
1111111111111111111111111111111111111111111111111111111111111111111111111111111111111111111111111111