
F 223, 224, 219
C 0 0 0

SO ./textures/so_tex.xpm
WE ./textures/we_tex.xpm
NO ./textures/no_tex.xpm
EA ./textures/ea_tex.xpm



111111111111111111111111111111111
100011100011100011100011100010001
101000100000000000100000100100001
100000100111111111100100100000001
100000100100000000100100100000001
100000100100000000100100100000001
100000100100000000100100100000001
100000100111111111100100100000001
100000100000000000000100100000001
100000100011100011100011100000001
100000100011100011100011100000001
100000100100100100100100100000001
100000100100100100100100100000001
100000100100100100100100100000001
100000100000000000000100100000001
100000100111111111100100100000001
100000100100000000100100100000001
100000100100000000100100100000001
100000100100000000100100100000001
100000100100000000100100100000001
100000100111111111100100100000001
100000100000000000000100100000001
100000100011100011100011100000001
100000100011100011100011100000001
100000100100100100100100100000001
100000100100100100100100100000001
100000100100100100100100100S00011
100000100000000000000100100000111
100000111111111111111100100001111
100000000000000000000000000011111
111111111111111111111111111111111